#######################################
# Datatypes (KEYWORD1)
#######################################

TinySI4732	KEYWORD1
tGetRev	KEYWORD1
tTuneStatus	KEYWORD1
tRsqStatus	KEYWORD1
tAgcStatus	KEYWORD1
tRadio	KEYWORD1

#######################################
# Methods and Functions (KEYWORD2)
#######################################

reset	KEYWORD2
setup	KEYWORD2
powerUp	KEYWORD2
powerDown	KEYWORD2
setRadio	KEYWORD2
getRev	KEYWORD2
setFreq	KEYWORD2
setBfoFreq	KEYWORD2
addFreq	KEYWORD2
setStereo	KEYWORD2
getRsqStatus	KEYWORD2
getIntStatus	KEYWORD2
seekStart	KEYWORD2
seekNow	KEYWORD2
getTuneStatus	KEYWORD2
setFilter	KEYWORD2
getFilterSize	KEYWORD2
setAgcOn	KEYWORD2
setAgcGain	KEYWORD2
getAgcGainSize	KEYWORD2
setVolume	KEYWORD2
setMute	KEYWORD2
getLabel	KEYWORD2
commandOut	KEYWORD2
setProperty	KEYWORD2
getProperty	KEYWORD2
patchFlashRomLoad	KEYWORD2
patchExtEepRomLoad	KEYWORD2

#######################################
# Constants (LITERAL1)
#######################################
FM	LITERAL1
AM	LITERAL1
LSB	LITERAL1
USB	LITERAL1

POWER_UP	LITERAL1
GET_REV	LITERAL1
POWER_DOWN	LITERAL1
SET_PROPERTY	LITERAL1
GET_PROPERTY	LITERAL1
GET_INT_STATUS	LITERAL1
SSB_TUNE_FREQ	LITERAL1
SSB_TUNE_STATUS	LITERAL1
SSB_RSQ_STATUS	LITERAL1
SSB_AGC_STATUS	LITERAL1
SSB_AGC_OVERRIDE	LITERAL1

AM_TUNE_FREQ	LITERAL1
AM_SEEK_START	LITERAL1
AM_TUNE_STATUS	LITERAL1
AM_RSQ_STATUS	LITERAL1
AM_AGC_STATUS	LITERAL1
AM_AGC_OVERRIDE	LITERAL1

FM_TUNE_FREQ	LITERAL1
FM_SEEK_START	LITERAL1
FM_TUNE_STATUS	LITERAL1
FM_RSQ_STATUS	LITERAL1
FM_RDS_STATUS	LITERAL1
FM_AGC_STATUS	LITERAL1
FM_AGC_OVERRIDE	LITERAL1

AM_CHANNEL_FILTER	LITERAL1
SSB_BFO	LITERAL1
SSB_MODE	LITERAL1
FM_DEEMPHASIS	LITERAL1
FM_CHANNEL_FILTER	LITERAL1
FM_SEEK_BAND_BOTTOM	LITERAL1
FM_SEEK_BAND_TOP	LITERAL1
FM_SEEK_FREQ_SPACING	LITERAL1
FM_BLEND_RSSI_STEREO_THRESHOLD	LITERAL1
FM_BLEND_RSSI_MONO_THRESHOLD	LITERAL1
FM_BLEND_SNR_STEREO_THRESHOLD	LITERAL1
FM_BLEND_SNR_MONO_THRESHOLD	LITERAL1
AM_SEEK_BAND_BOTTOM	LITERAL1
AM_SEEK_BAND_TOP	LITERAL1
AM_SEEK_FREQ_SPACING	LITERAL1
RX_VOLUME	LITERAL1
RX_HARD_MUTE	LITERAL1

L_MODE	LITERAL1
L_FREQ	LITERAL1
L_STEREO	LITERAL1
L_FILTER	LITERAL1
L_AGC	LITERAL1
L_VOLUME	LITERAL1
LABEL_SIZE	LITERAL1
